11111111111111
10C01000000001
10P01011111101
1000101E000101
1C000011C10001
11111111111111