1111111111111111
10000000000000P1
10C010010C010001
1111100000010001
1E00C00C00010C01
1111111111111111