11111111111111
10000C10000001
100P0C00111101
10000C01E00101
10000C00110001
11111111111111
